School,LeagifyPoints,Bid,ProjectedPoints,Difference,Owner
Washington,100,76,167,-67,Jawad
Alabama,75,60,174,-99,AJ
LSU,70,69,131,-61,Jared
Georgia,60,68,161,-101,Ross
USC,50,35,77,-27,Jared
Michigan,45,191,162,-117,Netten
Penn State,40,43,115,-75,AJ
North Carolina,35,18,61,-26,AJ
Ohio State,35,29,81,-46,AJ
Notre Dame,35,20,83,-48,Jawad
Oregon,30,45,107,-77,Ross
Oregon State,30,10,45,-15,Jared
UCLA,30,14,53,-23,AJ
Texas,30,48,155,-125,Jared
Florida State,30,36,129,-99,Jawad
